#########################
#S#     #               #
# # ### ### ########### #
# # # #   # #         # #
# # # ### ### ####### # #
#   #   #     #     #   #
##### # ####### ### ### #
#     #   #     # #   # #
# ####### ### ### ### # #
# # #         #     # # #
# # # ##### ####### # # #
# #   #   # #     #   # #
# # ### # # # ### # ### #
# #   # # # #   # # #   #
# ### # # ### ### # # ###
#   # # #   # #   # #   #
### # # ### # # ####### #
#   # # # #   #     #   #
# ##### # ######### # ###
#       #     #   # #   #
# ####### ### # # # ### #
#     #   # # # # #   # #
##### ### # # # # ### # #
#         #     #   #  E#
#########################
