#########################
#S  #         #       # #
### ### ##### # # ### # #
# #   # #     # # #   # #
# ### # # ##### # # ### #
#   # # #       # #   # #
# ### # ######### ### # #
# #   # #   # #   # # # #
# # ### # # # # ### # # #
#   #   # #   # #   #   #
# ### ### ##### # # ### #
# #   #     #   # # #   #
# # ####### # ### ### ###
# # #     # # #     # # #
# # # ### # # ##### # # #
# #   #     #     #   # #
# ############# # ### # #
#   #     #   # #   #   #
### # ### # # ### # #####
# #   # # # #   # #     #
# ##### # # ### ####### #
#       # # # #   #     #
# ### ### # # ### # ### #
#   #       #       #  E#
#########################
