#########################
#S      #     #   #     #
####### ### # ### # ### #
#     #   # #   # # # # #
# ### ### # ### # # # # #
# #   #   # # # # #   # #
# # ### ### # # # ### # #
# #   #     # # # #   # #
# ### ####### # # # ### #
# #   #       # # # # # #
# ### # ####### # # # # #
#   #   #       #   # # #
# # ##### ####### ### # #
# # #   #   #     #   # #
### # # ### # ####### # #
#   # #   # #         # #
# ### ### # ######### # #
#     #   #     #     # #
# ##### ####### ####### #
# #   #       #     #   #
# ### ##### # ##### # ###
#       # # #     # #   #
####### # # ####### ### #
#         #            E#
#########################
