#########################
#S#         #     #   # #
# ### ##### # # # # # # #
#   # #   #   # # # # # #
### # # # ##### # # # # #
# # # # # #   # #   #   #
# # # # # ### # ####### #
#   #   #   # #   #     #
# ### ##### # ### # #####
#   # #   #     # # #   #
### ### # ##### # ### # #
# #   # # #     #   # # #
# ### # # ######### # # #
#   # # #     #   #   # #
# ### # ##### # # ##### #
#     #   #   # # #     #
# ####### # ### # # #####
#     #   #   # #   #   #
##### # ##### # ##### # #
#   #   #   # #       # #
# ####### ### ######### #
#       #     #   #   # #
# # ##### ##### # # # # #
# #             #   #  E#
#########################
