#################################################################
#S# #       #   #         #   #         #       #   #           #
# # # # ### # # ### ##### # # # # ####### # ### ### # ##### ### #
# # # #   #   #     # #   # # # #       # # #     # # #     #   #
# # # ### ########### # ### # # ####### # # ##### # # # ##### ###
# #   # # #   #       #   # #         #   #     # #   #     # # #
# # ### # # # ##### ##### # ######### ######### # ### ##### # # #
# #     #   #     #       # #   #         #   # #   # #     # # #
# ############### # ######### # ########### # # ### ### ##### # #
#                 #           #             #   #       #      E#
#################################################################
