#########################
#S#       #         #   #
# # ##### ##### ### ### #
# # #   #     #   #     #
# # ### ##### # # ##### #
# #   #   #   # #   #   #
# ### # ### ####### # ###
#     #   #   #     # # #
######### ### # ##### # #
#           #   #   #   #
# ##### ######### ##### #
# #   #   #   #       # #
# # ##### # # # ##### # #
# #   #   # #   # #   # #
# ### # # # ##### # ### #
#     # # #       # #   #
##### # ##### ##### # ###
#   # #     # #   # #   #
# # # ### ### # # # ### #
# # #   #   # # #     # #
# ##### ### # # ####### #
# #   # # #   #         #
# # # # # ###############
#   #                  E#
#########################
