#########################
#S#           #     #   #
# ####### ### ### # # # #
#       #   # #   # # # #
####### ### # # ### # # #
#     #   # # # #   # # #
### ##### # # # ### # # #
#   #   #   # #   #   # #
# ### # ##### ### ##### #
#     #     #     # #   #
# ####### ######### # ###
# # #   #           #   #
# # # # ####### # # ### #
# # # # #     # # # #   #
# # # # # ### ### # # ###
# # # #   # # #   # #   #
# # # ##### # # ### ### #
# # #   #       #     # #
# # ### ######### ##### #
#   #   #     #     #   #
### # ### ### ####### ###
# # #   # # # #     #   #
# # ### # # # # ### ### #
#     #     #     #    E#
#########################
