#########################
#S    #   #   #         #
##### # # # # # ####### #
# #   # # # #   #       #
# # ### # ####### ##### #
#   #   #         #   # #
# ##### ########### # # #
#   #   # #         #   #
### # ### # #############
# # # #   #   #         #
# # # # ##### # # ##### #
# #   # #   # # # #   # #
# ##### # # # # # # ### #
#     #   # # # # #     #
# ### # ### # ### # #####
#   # # # # #     #   # #
# # # # # # ######### # #
# # # #   # #       #   #
# # ##### # # # ####### #
# #       #   #       # #
# ################# ### #
# #       #       # #   #
# ##### # ##### # # # ###
#       #       # #    E#
#########################
