#################################################################
#S#   #     #             #       #           #       #   #     #
# # # # ### # ######### ### ### # ####### ### ### ### ### # # ###
#   # #   # # #   #   #   # # # #         # #     # #   # # #   #
##### ### # # # ### # ### # # # ########### ####### ### # # ### #
#   #   # #   # #   #   #     # #       #   #   #       #     # #
# ##### ##### # # ##### ####### # # # ### # # # # ############# #
# #   # #   #   # #   # #     # # # # #   # # #   #           # #
# # # # # # ##### # ### # ### # # # ### ### # ########### ### # #
#   #     #       #       #     # #       #               #    E#
#################################################################
