#################################################################
#S      #         #           #       #     #     # #           #
####### # ######### ####### # # ##### # ### # ### # # ####### # #
# #   # #       #   #     # #   #   # #   # # #   #     #   # # #
# # # # # ##### # ### ### # ##### # # ### # # # ####### # # ### #
#   #   # #   #       #   #   # # # #     # # # #     # # #   # #
# ######### # ############### # # # ####### # # # ### ### ### # #
# #         #   #       #     #   # #     # # # # # # #   #   # #
# ####### ##### # ##### # ##### ### # ### # # # # # # # ### ### #
#         #       #       #       #     #     #   #     #      E#
#################################################################
