#########################
#S#     #     # #       #
# ### # ### # # # # ### #
# #   #     # #   #   # #
# # ######### ### ### # #
# # #   #   #   #   # # #
# # # # # # ### ##### # #
#   # # # #     #   # # #
##### # # ####### # # # #
#     # #         # # # #
# ##### ########### # ###
# #   #   #   #     #   #
# # ### ### # # ####### #
# #     #   #   #       #
# # ##### ######### ### #
# #     #           #   #
# # ################# ###
# # #       # #       # #
# # # ### # # # ####### #
# # # #   #   # #       #
# ### # ### ### ### ### #
# #   # #   #   #   # # #
# # ### ##### ### ### # #
#     #           #    E#
#########################
