#################################################################
#S    #     #     #             #             #                 #
##### # # # # # ### ##### ##### # ##### ##### # ### ########### #
#   # # # #   # #       #   # # # #   #   # # #   # # #       # #
# ### ### # ##### ######### # # ### # # # # # ##### # # ##### # #
#     #   # #     #   #   # #       # # # # #   #   #   #     # #
# ##### ##### ##### # # # # ######### ### # ### # ### ### ##### #
#   #           #   # # # #   #     # #   #   #   # #   #       #
### ############# ### # # ### # ### # # ### # ##### ### #########
#                 #     #     #   #     #   #                  E#
#################################################################
