#################################################################
#S  #           #   #                   #           #     #     #
### ####### ### # # # # ############### # ######### # # # # ### #
#   #   #   # #   # # #   #       #   # # #       # # # # # # # #
# ### # # ### ##### ##### # ##### # # # # ####### # ### ### # # #
# #   # # #       #       # #   # # # #   #       #   #       # #
# # ### # # ############### # # ### # ##### ######### ######### #
# # # # # # #               # #     # #     #   #   # #   #   # #
# # # # # # # ####### ####### ####### # ### # # # # # # # # # # #
#   #     #         #               #     #   #   #     #   #  E#
#################################################################
