#########################
#S#   #             #   #
# # # # ######### # # # #
# # #         #   #   # #
# ######### ### ####### #
#         # #   #     # #
######### ### ### # ### #
#     #   #   #   # #   #
# ### # ### ### ##### ###
#   # #     # #   #   # #
##### ####### # # # ### #
#   #         # #   #   #
# # ##### ##### ####### #
# #       #     #     # #
# ####### # ##### ### # #
# #   #   #   #   # #   #
# # # ####### ### # ### #
# # # #       #   #     #
# # # # ####### ### #####
#   # # #     # #   #   #
# ### # ### # # ### # # #
# # #   #   # #   # # # #
# # ##### ### ### # ### #
#         #       #    E#
#########################
