#################################################################
#S  #           #               #       # #               #     #
### ### ### ### ##### ######### # ### # # # ### ########### ### #
# #   #   # #   #   # #   #     # #   # #     #     #       #   #
# ### # ### # ### # # # ### ####### ### # ####### # # ####### ###
#   # # #   # #   # # #   # #     # #   #   #   # #         #   #
# ### # # ### # # # # # # # ### # # ### ##### # # ############# #
# #   # #   # # # #   # # #   # # #   #       # #   #   #     # #
# # ####### # ### ##### # ### # # ### ######### ##### # # ### # #
#           #     #     #       #     #               #   #    E#
#################################################################
