#################################################################
#S  #             #           #                 #     #     #   #
### ######### ##### # ####### # ############# # ### # ### # # # #
# # #       #   #   #     #   # #           # # #   #     # # # #
# # # ##### ### # ####### # ##### ######### # # # ######### # # #
#   # #   #   #       #   # #     # #       # #   #   #     # # #
# ### # # ### ######### ### # ##### # ####### ####### # ##### ###
# #   # #   #     #   # # # # #     # #       #       #   #     #
# # ### ######### # # # # # # # ### # ##### ### # ####### ##### #
#   #               #   #     #   #         #   #              E#
#################################################################
