#################################################################
#S  #         #       #     #       #   #         #             #
### # ####### # ### # # ### ### ### # # ### # ### ######### ### #
# # #       # #   # # # # #     # #   #   # #   #   #     #   # #
# # # ##### # ##### # # # ####### ####### ##### ### # ### # # ###
# # #   #   #   #   #   #   #       #   #       #   # #   # #   #
# # ### # ##### # ####### # # # ### # # ######### ### # ####### #
# # #   # #   #   #   #   # # #   #   #         # #   # #     # #
# # ##### # ####### # # # ### ### ############### ### # # ### # #
#         #         #   #       #                     #   #    E#
#################################################################
