#########################
#S#     # #             #
# # ### # # # ######### #
#   # # #   #       # # #
##### # # ######### # # #
#     # # #     #   #   #
##### # ### ### # ### ###
#     # #   #   #   #   #
# ##### # ### ### # ### #
# #     # #   # # #   # #
# # ##### # ### # ### # #
# # #     #   #     # # #
# # # ####### ####### # #
# # #     #   #       # #
# # ##### ### # ####### #
# #     #   #   #       #
# ##### # # ######### ###
#   #   # # #       #   #
# # # ### # # ##### ### #
# # # #   #     #   #   #
# # # ########### ### ###
# #   #     #   #   #   #
# ##### ### # # ### ### #
#       #     #     #  E#
#########################
