#########################
#S#   #     #       #   #
# # # # ### # ### # # # #
# # #     # #   # #   # #
# ######### ### # ##### #
# #   #   #     # #     #
# # # # # ####### # #####
# # #   #         # #   #
# # ############### # ###
# #   #       # #   #   #
# ### ##### # # # ##### #
#   # #     #   #       #
### # # ####### ####### #
# # # #       # #     # #
# # # ####### ### # ### #
# # #       # #   # #   #
# # # ##### # # ### # ###
# # #     # # #   #   # #
# # ##### # # ### ##### #
#   #   # # # #   # #   #
# ### # ### # # ### # # #
# #   # #   # #   #   # #
# # ### # ### ### ##### #
#   #     #            E#
#########################
