#################################################################
#S#       #             #             #   #   #           #     #
# # ##### ##### ##### ### ##### ##### # # # # ### ####### ### # #
# # #   #     # #   #   #   # # # #   # #   # #   # #   #   # # #
# # ### ##### # # # # # ### # # # # ### ##### # ### # # ### ### #
# #   #   #   # # # # #       # #   #   #   #   #   # #   #     #
# ### # ### ##### # # ######### ### # ### ####### ### ### ##### #
#     #   #   #   # #   #     #   #   #           #   # #     # #
####### # ### # ### ##### ### ### ##### ##### ##### ### ### ### #
#       #       #         #       #         #             #    E#
#################################################################
