#################################################################
#S#       #     #         #       #       #       #         #   #
# # ### # # ### # # ##### # ##### ### ##### # ##### ####### # # #
# #   # #   # # # # #   #   #   #   #       #       #     # # # #
# ##### ##### # ### # # ##### ##### ############### # ### # # # #
#     # #   #     #   #     # #     #       #     # # #   #   # #
##### # # # ##### ######### # # ##### ##### # ### ### # ### ### #
# #   #   #   # #   #       #   #       # # #   #     #   #   # #
# # ######### # ### # ####### ######### # # ### ######### ##### #
#             #       #                 #       #              E#
#################################################################
