#########################
#S#             #       #
# ##### ####### # ##### #
#       #     #   #     #
######### ######### #####
#     #           #   # #
# ### # ##### ####### # #
#   # # #   #       # # #
### ### # # ##### ### # #
#   #   # # #   #     # #
# ### ### # ### ####### #
#   #   # #   #   #     #
# # ### # ### # # ### # #
# #     #   #   #   # # #
# ######### ####### # # #
#   #       # #   # # # #
### ### ##### # # # # # #
# #   #   #     # #   # #
# ### # # ### ### ##### #
# #   # #   #   #   #   #
# # ####### ### ### # ###
# #         #   #   #   #
# ########### ### ##### #
#               #      E#
#########################
