#########################
#S  #               #   #
### ### ########### ### #
# #     #   #     #     #
# ####### ### # # ##### #
#   #     #   # # #   # #
# ### # ### ### # # # # #
#     # #   # # # # #   #
# ##### # ### # ### #####
# # #   # #   #   # #   #
# # # ### ### ### # # ###
#   #   #   #   # # #   #
### ### ### # ### # ### #
# # #   #   # #   #   # #
# # # # # ### # ##### # #
#   # # #   # #       # #
# ### ##### # ######### #
#   #     # #   #       #
####### ### # ### # ### #
#       #   #     #   # #
# ####### ########### ###
# #     # #     #   #   #
# # ### # # ### # # ### #
#     #     #     #    E#
#########################
