#########################
#S#   #             #   #
# # # # ##### ##### # # #
#   # # #     #   #   # #
##### # # ##### ####### #
# #   # #   #       #   #
# # ##### # # ##### # ###
#   #   # # # #   # # # #
# ### # # # # # # # # # #
#     # # # #   # # # # #
####### ### ### ### # # #
#     #     #   #   #   #
### # ########### # ### #
#   #             # #   #
# ################# # ###
#         #         #   #
# ####### ######### ### #
#     # #     #   #   # #
##### # ##### # # # ### #
# #   #     # # # # #   #
# # ##### # # # # ### ###
# # #     # #   # #   # #
# # ### ### ##### # ### #
#       #       #      E#
#########################
