#################################################################
#S  #           #       #       #       #         #     #   #   #
### # ### ##### ### ### # ##### ### ##### ### ### ##### # # # # #
# # # # # #   #     # # # #   #   #     # # # #   #   #   #   # #
# # # # # # # ####### # # # ##### # ### # # # # ### # ######### #
# # #   #   # #       #   #     # #   #     # #     #       #   #
# # ### ##### # ### ######### # # ### ####### ############# # ###
#   #   #     #   #   #       # # #   #     #     #       # #   #
# ####### ####### ### # # ####### ##### ### ##### # ##### # ### #
#         #         #   #               #         #     #      E#
#################################################################
