#########################
#S#       #             #
# ##### # # # ###########
#     # #   #     #     #
##### # ######### # ### #
#     # #   #     # #   #
# ##### # # # # ### # # #
# #   #   # # # #   # # #
# ### ##### # ### ### ###
#   #       #       #   #
### ################### #
# #     #     #     #   #
# ##### # ### # ### # ###
#     # # # #   #   #   #
### # # # # ##### ##### #
#   # #   #     #   #   #
# ######### ### ### # ###
# #   #     #     # #   #
# # # # ### ##### # ### #
# # # # # #     # #   # #
# # # # # ##### ##### # #
#   # #   #   #       # #
# ### ### ### ######### #
#   #                  E#
#########################
