#########################
#S          #           #
########### ####### ### #
#       #   #       # # #
##### # # ### ####### # #
#     # # #   #       # #
# ##### # # ##### # # # #
#     # #   #   # # # # #
##### # ##### # # # ### #
#     #     # # # # #   #
# ### ##### # # ### # ###
# # # #   #   #   # #   #
# # # # # ####### # ### #
# #   # #   #   #   #   #
# ##### ### ### ### # ###
#       # #   #     # # #
# ####### ### ##### # # #
# #         #     # # # #
# ### ########### # # # #
#   #         #   # # # #
### # ####### # ##### # #
# # # #     # # #     # #
# # ### ### # # # ##### #
#       #     #        E#
#########################
