#################################################################
#S        #                   # #             #         #   #   #
######### ######### ### ##### # # ### ####### # ####### # # ### #
#   #   #         # #   # #   #     #       #   #     #   #     #
# ### # ######### # # ### # ##### ######### ######### ######### #
# #   #       # # # # #   #     # #         # #         #       #
# # ### ##### # # # # ### ##### ### ######### # # ##### # #######
# # #   #       # # #   #     # #   #   #     # #     # #       #
# # # ########### ##### # # ### # ### # # # ### ##### ######### #
#   #                   # #       #   #   #         #          E#
#################################################################
