#########################
#S#     #     # #     # #
# ### ### # # # # # # # #
#   #   # # #   # # #   #
### # # # # ##### # #####
# # # #   #     # # #   #
# # # ######### # # # # #
# # #         #   #   # #
# # ############# ##### #
# # #   #       # #   # #
# # # # # ##### # ### # #
#   # #   # #   # #   # #
# ### ##### # ### # ### #
# #   #   #   #     #   #
# ### # ### ######### ###
#     #     #       #   #
####### ####### ### ### #
#   # #   #     # #     #
# # # ### ### ### ##### #
# #     #     #         #
# ############# #########
#           #   #     # #
# ####### ### ### ### # #
#       #         #    E#
#########################
