#################################################################
#S#         #           #         #                 #       #   #
# ####### # # ######### ### ### # # ##### ######### ### ### ### #
#   #     #   #       #   # #   # #     #   #     #   #   #     #
### # ######### ### ##### # # ### ######### ##### ### # # ##### #
# # #     # #   # #     # # #   # #       #     #   # # # #   # #
# # ##### # # ### ##### # # ### # # ##### # ### ### # ### # # # #
# # #     # # #       # # # #   # # #     #   #   # # #   # #   #
# # # ##### # # ##### # # ### ### # # ########### # # # ### #####
#     #         #     #       #     #             #     #      E#
#################################################################
