#################################################################
#S#             #       #           #     #       #         #   #
# ##### ####### # ##### ######### # # # # ### ### # ### ##### # #
#       #     #   #   #         # #   # #     # # #   # #     # #
########### # ##### # ######### ### ### ####### # # # ### ##### #
#         # #   # # #   #     #   # #   #     #   # #     #   # #
# ####### ### # # # ### # # ##### ### ### ##### ### ####### # # #
# #     #     #   # # #   #     #     #   #   #   # #   #   #   #
# # ### ########### # ####### ######### # # # ### ### # # ##### #
#     #                     #           #   #         #   #    E#
#################################################################
