#################################################################
#S#         #   #           #       # #           #   #       # #
# # ####### # # # ##### # ### # ### # # ####### # # # # # ### # #
# #       #   #   #   # #   # # #   #   #       # # #   # # #   #
# ##### ####### ### # ##### # # ### # ### ####### ####### # ### #
#   #   #     #   # #     # # #   # # #   # #   #         #   # #
### # ### ### ### # ##### # # ### # ### ### # # ########### ### #
#   #   #   #   # #   # # #   #   # #   #   # #       #     #   #
# ######### ### ##### # # ##### ### # ### # # # ####### ### # ###
#           #         #         #     #   #   #           #    E#
#################################################################
