#################################################################
#S#   #     #       #   #         #       #   #   #             #
# # # # ### # # ### # # ### ####### # ### # # # # ### ####### # #
# # #   #   # # #     #   #         # #   # #   #   # #   #   # #
# ####### ### # ######### ##### ##### # ### ####### # ### # #####
#       #     #   #     #     #     # # # #   #   # #     # #   #
####### ####### # # ### ##### ##### # # # # # # # # ####### # # #
#     #   #   # # # # # #   # #     # # #   # # #   #     #   # #
# # ##### # # ### # # # # # # ####### # ##### # ##### ### ##### #
# #         #     #   #   #           #       #       #        E#
#################################################################
