#################################################################
#S#         #     #         #         #       #         #       #
# ##### ### ##### # ##### # ### ##### # # ### ### ##### # # #####
#     #   #     #       # #   # # #   # #   #   # #   # # #     #
##### ### ##### ####### # ### # # # ####### ### # ### # ####### #
#   #   # #   #   #     # #   # # #     #   #   #   # # #   #   #
# # ### # # # ### # ##### # ### # ##### # ### ##### # # # # # # #
# # #   # # #   # # #   # # #   #       # # # #   # # #   #   # #
# # # ### # ##### ### # # # ### # ####### # # # # # # ######### #
# #       #           #   #     #         #     #   #          E#
#################################################################
