#################################################################
#S#     #             #           #         #   #     #   #   # #
# # # ### ##### ##### ##### ### # ### ####### # # # # # # # # # #
# # #     #   #   #   #   # #   #   # #     # #   # # # #   #   #
# # ####### ##### ### # # # # ##### # # ### # ##### # # #########
# #   #   #     #   # # # # # #   # # # #   # #   # # #   #     #
# ### # # ##### ### # # # # # # # # # # # ### # ### # # # # ### #
# #     #         # #   # # # # #   #   #       #   # # #   #   #
# ################# ##### ### # ################# ### ####### # #
#                   #         #                   #           #E#
#################################################################
