#################################################################
#S  #           #   #     #               #         #         # #
### ######### # # # # ### # ######### ### # ####### # ####### # #
# #       #   #   #   # # #   #       # # # #     # # # #     # #
# ####### # ########### # ### # ####### # # ### ### # # # ##### #
#       #   #       #   # #   #   #       # #   #   # # #   #   #
# ########### ####### # # ##### # # ####### # ### ### # ### # ###
#       #   #   #   # # #     # # #   #     # #   #   #   # #   #
# ##### # # # # # # # # ##### ### ### ##### # # ### ### # # ### #
#     #   #   #   #   #           #         #       #   #      E#
#################################################################
