#########################
#S      #       #     # #
####### # # ### # ### # #
#     # # #   # # #   # #
# # ### ### # # # # ### #
# #   #   # # # # #     #
# ### ### ### # # #######
# # #   #     # # #     #
# # # ######### # # ### #
#   #   #     # # # #   #
####### # # # # # # # ###
#   #   # # # # #   #   #
# # # ### # # # ##### # #
# #   #   # # # #   # # #
# ### # ### # # # # ### #
# # # # #   # #   #     #
# # # # # ### ######### #
# # # # # # #   #     # #
# # # # # # ### # # ### #
# #   # # #       # #   #
# ##### # ### ####### ###
# #   # #   #   #   #   #
# # # # ### ##### # ### #
#   #     #       #    E#
#########################
