#################################################################
#S#       #     #     # #     #     #           #         #     #
# ### ### ### # ### # # # # # # ### ### ### ### # # ##### # ### #
# #   #       #   # # #   # #   # #   #   # #   # # #   # #   # #
# # ############# # # ### # ##### ### ### # ### ### # # # ##### #
# #     #       #   #   # # # #     #   # #   #     # # #   #   #
# ##### ##### # ####### ### # # # ##### ##### ####### ##### # # #
#   #   #     #   #     #   # # #       #   #     #       #   # #
### # ### ######### ##### ### # ######### # ##### # ##### ##### #
#     #                   #               #       #     #      E#
#################################################################
