#################################################################
#S  # #           #     #     #       #                   #     #
### # # # ######### ### # # # ##### # # # # ############# # ### #
#   #   #             #   # #     # #   # # #     #     #   # # #
# ########### ####### ##### ##### ##### # ### ### # ### ##### # #
#       #   # #     # # #   #   #     # # #   #   #   #   #   # #
####### # # # # ### # # # ### ####### # # # ### ##### ##### # # #
#   #   # # # # #   #   # #   #     # # #   #   #     #     #   #
# ### ### # ### # ####### # ### # ### ####### ### ##### #########
#         #     #         #     #             #                E#
#################################################################
