#################################################################
#S              #       #     #             #         #   #     #
############### ### # # # ### ########### # # # ##### # # # ### #
#   #         #   # # # #   # #     #   # #   #   # # # #   #   #
# ### # ##### ### ### # ### # # ### # # ##### ### # # # ##### ###
# #   # #   #   # #   #   # # # #     #     # #   # # #     # # #
# # ### ### ### # # ##### # # # ########### ### ### # # ### # # #
# # # #   #     #   #   #   # #     #     #     # #   # #   # # #
# # # ### ########### # ##### ##### # ########### # ##### ### # #
#       #             #             #                     #    E#
#################################################################
