#########################
#S  #       #   #       #
### # ##### # # # ##### #
# # #     #   #     #   #
# # ##### ##### ##### # #
#   #     #   # #     # #
# ######### # ### ##### #
# #     #   #     # #   #
# # ### # ######### # ###
#   # # # #     #   #   #
##### # # # ##### # ### #
#   # #   # #     # #   #
# # # ##### # ##### # ###
# # #     #   # #   # # #
# # # ### # ### # ### # #
# #   #   #     #     # #
# ##### ####### ####### #
# #     #     # #       #
# ### ##### ### # ##### #
#   #     # #   # #   # #
# # ##### # # ##### # # #
# #   #     # #     # # #
# ### ####### # ##### # #
#   #           #      E#
#########################
