#########################
#S      #               #
####### ######### ### ###
#     #         #   #   #
# ############# ####### #
#         #   #       # #
# ### ### # ######### # #
# #   #   #         # # #
### ### ##### ##### # # #
#   # # #     #   # #   #
# ### # # # ### # ##### #
#   #   # #     #     # #
# # # ############# ### #
# # #       #       #   #
### ####### # ####### ###
#   #   # #   #       # #
# # # # # ### # ####### #
# # # # # #   #         #
# # # # # # ########### #
# # # # #           #   #
# ### # ####### ##### ###
#   # #       # #   # # #
# # # ####### ### # # # #
# #         #     #    E#
#########################
