#########################
#S#       #             #
# # # ##### ##### ##### #
# # #   #   # #   #   # #
# ##### # ### # ### # ###
#     # #     #     #   #
##### # ##### ######### #
# #   #     #         # #
# # ##### ### ######### #
# #     # #   #       # #
# ##### # # ### ##### # #
#       #     # #   # # #
# ############# # # # # #
#               # # # # #
################# # # # #
#             #   # #   #
# ######### # # ### ### #
# #         #   #   #   #
# # # ############### ###
# # # #         #     # #
# # ### ####### # ##### #
# #     #       # #     #
# ####### ####### # ### #
#       #           #  E#
#########################
