#################################################################
#S#   #           #   #     #   #       #     #     #   #     # #
# # # # ######### # # # ### # # ##### # ### # ### # # # ### # # #
#   # #   #     #   # #   #   #   #   #   # #   # #   #     #   #
##### # # # ######### ### ####### # ##### # ### # ############# #
# #   # # # #       #   #   #   #   #   #   # # #   #         # #
# # ##### # # ### ##### # # # ####### ####### # ### # ####### # #
#   #   # #   #   #   # # # #   #     #   #     #   # #   #   # #
# ### # # # ### ### # # ### # # # # ### # # ##### ### ### # ### #
#     #   #   #     #       # #   #     #         #       #    E#
#################################################################
