#########################
#S        #       #     #
######### ##### # # ### #
#   #     #   # #   # # #
# # # ##### # ##### # # #
# # # #     #     #   # #
# # # ### ####### ### # #
# #   #   #     # #   # #
# ##### ### ### # # ### #
# #     #   # #   #   # #
# # # ### ### ######### #
# # # # #   #   #     # #
# ### # ### # # # # # # #
#     #     # #   # #   #
####### ########### ### #
#     # #         # #   #
# ### # # ####### # ### #
# #   #   #   #   #   # #
# ######### ### ##### # #
#       #   #   #     # #
# ##### # # # ### # #####
#     #   #   #   #     #
##### ################# #
#                      E#
#########################
