#########################
#S  #           #   #   #
### ######### # # # # # #
# #       #   #   #   # #
# ####### # ########### #
#       #   #   #     # #
# ##### ##### ### # # # #
# #   #   #       # # # #
# ### # # ##### ### ### #
#     # #     # #   #   #
##### # ##### # # ### ###
#     # #   # # #   #   #
# ##### # ### ##### ### #
# #     #     #       # #
### # ##### ### ##### # #
#   # #   # #     #   # #
# ##### # # ##### # ### #
#   #   # # #     # #   #
### # ### # # ####### ###
#   # # # # # #     #   #
# ### # # # # # ### ### #
#   # # # #   # # # #   #
# # # # # ##### # # # ###
# #     #         #    E#
#########################
