#################################################################
#S      # #               # #     #       #     #               #
####### # # ########### # # # ### # ##### # # # ### ########### #
#   #   #       # #     # #   #   #     #   # #     # #       # #
# # # ######### # # ##### ##### ##### ####### ####### # # ##### #
# #   #     #     # #   # #   # #     #       # #       #   #   #
# ##### ### ##### # # # # # # # # ##### ####### # ######### # ###
#   #   # #     # # # # # # # #   #     #   #   # #       # #   #
### ### # ##### ### # ### # # ##### ##### # # # # ##### # # ### #
#       #           #       #       #     #   #         # #    E#
#################################################################
