#########################
#S#   #         #       #
# # # # # ##### ####### #
# # # # # #             #
# # # ### ############# #
#   #   #     # #     # #
####### ##### # # # ### #
# #     #     #   # #   #
# # ##### ######### # ###
# #     # #         #   #
# ##### # ### # ####### #
#     #   #   # #       #
### # ##### ### # #######
#   #   #   #   #   #   #
# # ##### # ####### # # #
# # #     #       # # # #
# ### ########### # ### #
#   #     #   #   #     #
### ##### # ### ####### #
#       # # #   #       #
# ##### # # # # # #######
# #   # #   # # # #     #
# # # ##### # ### ### # #
#   #       #         #E#
#########################
