#########################
#S#                   # #
# # # ############### # #
# # #         #     #   #
# # ####### # ### ##### #
# #   #   # #   #       #
# ### # # ##### # #######
# #   # #   #   #     # #
# ##### ### # ####### # #
# #     # # # # #       #
# # ##### # # # # #######
# #     #     #   #     #
# ##### ####### ### ### #
# #   #   #       #   # #
# # # ### ######### ### #
# # #   # #       # #   #
# # ### # # ##### # # # #
#   #   #     # # # # # #
##### ####### # # # # # #
# #   #     #   #   # # #
# # ##### # ### ##### ###
# # #     #   #     #   #
# # ### ##### ######### #
#       #              E#
#########################
