#########################
#S      # #     #       #
####### # # # ### ##### #
# #   # #   #         # #
# # # # # ############# #
#   #   #   #     #   # #
# ######### # # ### # # #
# #       # # # #   # # #
# ### ### # ### # ### # #
#   # #   # #   #   # # #
### # ### # # ##### # # #
#   #   # # # #     # # #
# ### # ### # # ##### # #
# # # #     # # #       #
# # # ##### # # ### #####
# #   #   #   #   # #   #
# ##### # ####### ### # #
#     # #   #   # #   # #
##### # ### # # # # ### #
#     # #     # # # #   #
# ##### ####### # # # # #
#     #   #     #   # # #
##### ### # ######### # #
#         #           #E#
#########################
