#################################################################
#S  #       #     #   #         #           #   #             # #
### ####### # # # # ### ####### # ##### ### # # # ##### ### # # #
# #   #   #   # # #       #   #   # #   #     # # #   # #   # # #
# ### # # ##### # ##### ### # # ### # ######### ### # ### ### # #
#   #   # #     #     # #   # #     #     #   #   # #     # # # #
# # ##### # ######### # # ### ########### # ##### # ####### # # #
# # #     #     # #   # # # # #   #   #   # #     # #   #   # # #
# ### ######### # # ##### # # # # # # # ### # ##### # ### # # # #
#               #         #     #   #   #           #     #    E#
#################################################################
