#########################
#S    # #     #         #
##### # # ### # ####### #
#   # # # # #   # #     #
# ### # # # ##### # ### #
#     #           # # # #
# ########### ##### # # #
#   #     #   #     #   #
### ### # ### # ####### #
# #     #   # #   #   # #
# ######### ### # # # # #
#         #   # #   # # #
### ######### ##### # ###
#   #       #     # #   #
# ### ### # ##### # ### #
#     # # # #     #   # #
# ##### # ### ####### # #
#   #   #   #   #     # #
### ### ### ### ####### #
# #     #     #   #   # #
# ##### # # ##### # # # #
#   #   # # #   # # # # #
# # # ### ### # # # # # #
# #     #     #     #  E#
#########################
