#################################################################
#S#     #                       # #             #     #         #
# # ### ### ########### ####### # # ####### ### # # ### ####### #
# # # #   # #         #       # # #   #   #   # # #     #       #
# # # ### ### ####### ### ### # # ### # # ### # # ####### ##### #
#   #   #     #     #   #   # # #     # #   # #     #     #   # #
##### # ######### ##### ### # # ####### ### ######### ##### ### #
# #   #   #       #   # #   # #   #   # # # #         #   #     #
# # ### ### ### ### # # ##### ### # # # # # # ######### ### #####
#     #       #     #         #     #   #     #                E#
#################################################################
