#################################################################
#S#         # #               #                 #               #
# ####### # # # ########### # ######### ####### ##### ####### ###
# #       #   # #   #       #     #     #     #     #       #   #
# # ##### ##### # # # ########### # ##### ### ##### ##### ##### #
# #     # #   # # # #   #       # #   #   #     # # #     #   # #
# # ### ### # # # # ### # # ##### ### # ####### # # # ##### # # #
# #   #     #   # #     # #     #   # # #     #   # # #     # # #
# ############### ####### ##### ### # # # ### ##### ### ##### # #
#                 #           #       #     #           #      E#
#################################################################
