#########################
#S#             #       #
# ### ######### ### ### #
#   # #   #   #   #   # #
### # # # # # ### ##### #
# # #   #   #   #       #
# # # ######### ####### #
#   #         # #   #   #
# ##### ####### ### # ###
#   # # #     #   #   # #
### # # # ### ### # ### #
#   #   # #       # #   #
# ### ### ######### ### #
# #     #   #   #   #   #
# ##### ### # # # ### # #
#     #   # # # #     # #
##### ### # # # ### #####
# #   #   # # #     #   #
# # ##### # ######### # #
# # #   # # #         # #
# # # # ### # ######### #
# #   #   #   #   #     #
# ####### ##### # # ### #
#               #   #  E#
#########################
