#########################
#S# #       #   #       #
# # # ##### # # # # #####
# #       #   #   #     #
# ########### ######### #
# #   #     #     #   # #
# # # # ### ##### # # # #
#   # # # #     #   # # #
##### # # ##### ### ### #
#   #   # #   #   # #   #
# ####### # # ### ### # #
#         # #   #   # # #
# # ####### # # ### # ###
# #         # # # # #   #
# ########### # # # # # #
#       #   # #   # # # #
####### ### # # ### ### #
# #     #   # # #   #   #
# # ##### ### ### ### ###
#   #     #   #   #     #
# ####### # ### ####### #
#       # #     #     # #
####### # ######### # # #
#                   #  E#
#########################
