#########################
#S#   #   #           # #
# # # # # # ######### # #
# # # # # #   #     # # #
# # # # # ### # ### # # #
#   #   # #   #   #   # #
######### # ##### ##### #
# #     #   #   #     # #
# # ### ####### ##### # #
# # #               #   #
# # # ####### ######### #
#   # #   #   #       # #
# ### # # # ### ##### # #
#   #   # #   #   # #   #
### ##### ### ### # #####
# #     # #     #   #   #
# # ##### # ####### # # #
#   #     # #     #   # #
# ### ####### ### ##### #
# # #         #       # #
# # ########### ####### #
#   #   #   #   #   #   #
### # # ### # ### # # ###
#     #     #     #    E#
#########################
