#########################
#S#             #       #
# ### ######### # ##### #
#   # # #     #     #   #
### # # # ### ####### # #
# # #   #   #         # #
# # ####### #############
# # #       #           #
# # # ####### ######### #
# # #     #   #       # #
# # ##### # ##### # # # #
# #     #       # # # # #
# ##### ####### # # ### #
#     #   #   # # #   # #
### # ### # ### ### # # #
#   # #   #   #   # # # #
# ##### ### # ### # # # #
#   #   #   #   # # # # #
# # # ### ##### # ### # #
# # # #   #   #       # #
### # ##### # ####### # #
#   #   #   #   #   # # #
# ##### # ##### # # ### #
#         #       #    E#
#########################
