#########################
#S          #           #
########### # ######### #
#       #   # #   #   # #
# ####### ### # # # # # #
# #       #   # # # #   #
# # ########### # # #####
# # #       #   # #     #
# # # ##### # ### ##### #
# #   #   #   # #       #
# ##### ####### ####### #
#     #       #     #   #
# # # # ### ### ### # ###
# # # #   # #   # #   # #
# # ##### # # ### ##### #
# # #     # # # #       #
### # ##### # # # ### # #
#   # #     # #     # # #
# ### # ### # ####### ###
# #   #   # #   #   #   #
# # ##### ##### # # ### #
# #     # #   #   # #   #
# ##### # # # ##### # # #
#       #   #         #E#
#########################
