#################################################################
#S  #               #     #   #       #   #                 #   #
### ### ########### ### # # # # ##### # # # ####### # ##### ### #
# #     #         #     #   # # #   #   #   #     # # #   #   # #
# ####### # # ############### # ### ######### ### # # # # ### # #
#       # # # #             # #         #     # # # #   # #   # #
# # ##### # ### ##### ##### # ### ####### ##### # # ##### # ### #
# # #   # #     #   # #   # # #   #       #     # #   #   #     #
# # # # # ####### # # # # ### ##### ####### ##### ##### ####### #
# #   #           # #   #           #                   #      E#
#################################################################
