#########################
#S#                 #   #
# # ######### ##### # # #
# #         # #     # # #
# ########### # ##### # #
#   #     #   #   #   # #
### # ### # ##### ### # #
# #   #   # #   #     # #
# ##### ### # # ####### #
#   #   #   # #     # # #
### # ### # # ##### # # #
#   # #   # # #   # #   #
# ### # ### # ### # #####
#   # # #   # #   #     #
# # # # ##### # # ##### #
# #   #     # # # #   # #
# ######### # # # ### # #
#   #     #     #     # #
### ### # # ########### #
# #     # #   #     #   #
# ####### ##### ### # # #
# #     # #     # #   # #
# # # ### # ##### ##### #
#   #       #          E#
#########################
