#########################
#S    #         #     # #
##### # # ####### # # # #
#   # # #         # #   #
# # # # ########### ### #
# # # #           # # # #
# # # # ##### ##### # # #
# # # # #   # #   # #   #
# ### # # # ### # # # ###
# #   # # #   # #   #   #
# # ### # ### # ####### #
# #   # #   #   # #     #
# ### # ### ##### # #####
#   # #   #   #   #     #
# # # ####### # ####### #
# # #         # #     # #
### ########### # # ### #
#       #     #   #     #
# ####### # ### #########
#       # #   #   #   # #
# ##### # ### ### # # # #
#     # # # #   # # # # #
##### # # # ### # # # # #
#     #       #     #  E#
#########################
