#################################################################
#S    #     #       #     #   #       #       #   #     #   #   #
##### # ##### # ### # ### # # # ### # ### # # # # # # # # # # ###
#   # #       #   #   # # # #     # #   # # #   # # # # # # #   #
# # # # ######### ##### # ### ##### ### # # ##### ### # # # ### #
# # # # #         # #   #   # #   #   # # #   # # #   #   #   # #
# # # # # ######### # # ### ### # ### # # ### # # # ######### # #
# # # # # # #       # #   #   # #     # #   # # # #         # # #
# ### ### # # ### ### ### ### # ####### ##### # # ######### # # #
#         #     #       #       #             #             #  E#
#################################################################
