#################################################################
#S    #   # #       #     #                   #             #   #
##### # # # # ##### # ### # ##### ############# ######### # # # #
#   #   # #       #     #     # #             # #         # # # #
# # ##### ################### # ############# # # ######### ### #
# #     # #       #       #   #         #   #   #       # #   # #
# # ### # # ##### # ##### ### # ### ##### # # ######### # ### # #
# #   # # #   # #   #   #   #   #   #   # # #     #   # #   # # #
# ### ### ### # ##### ##### ######### # # # ####### # # # # # # #
#   #         #                       #   #         #   # #    E#
#################################################################
