#################################################################
#S#     #           #         #             #     #             #
# # # # # ######### # ####### # ######### # # ### ### # ####### #
# # # # #     #     # #   #   #       # # #   #     # #     #   #
# # # # # ### # ##### # # # ######### # # ######### ##### # # ###
# # # # # #   # #     # #   #       #   # #     #       # # #   #
# ### # ### ### ##### # ##### ##### ##### # ### ####### ### #####
#   # #   # # #     # #     # #   # #   #     #   #   #   #     #
### # ### # # ##### # ##### # # ### # # ######### # ##### ##### #
#     #     #         #       #       #           #            E#
#################################################################
