#########################
#S#                 #   #
# ##### ####### ### # ###
#     #   #     # # #   #
##### ##### ##### # ### #
#   # #     #     #   # #
# # # # ##### ### ### # #
# # # #     # #     #   #
# # # ##### # # ####### #
# # #   #   # # #   #   #
### ### # ### ### # # ###
#     # # #   #   #   # #
# ### # # ### # ####### #
#   # # #   #   #       #
### ### # # # ####### # #
#   #   # # # #       # #
# ### ### # # ### #######
#   #   # # #   # #     #
# # ### # # ### # # ### #
# #   # # #   # #     # #
# # ### # ### # # ##### #
# #     # #   # # #   # #
# ######### ### ### # # #
#           #       #  E#
#########################
