#################################################################
#S#             #           # #     #           #     #         #
# ##### ####### # ######### # # # # # ######### # # # # ### #####
#     #   #   # #       #   #   # #   # #     # # # # # # #     #
##### # # ### # ### ### # ####### ##### # # # # ### # # # ##### #
#     # # #   #   # #   #     #   #   #   # # #   # # #   #     #
# ####### # ##### # # ####### # ### ### ### ##### # ##### # ### #
# #       #       # # #   #   #   # #   #   #     #       # #   #
# ##### ### ######### # ### ##### # # ### ### ############# # ###
#       #             #           #     #                   #  E#
#################################################################
