#################################################################
#S  #     #                 #       #     #             #       #
### ### ### # ############# # ##### # ### # ######### # ### #####
# # #   #   #   #     #   # # #   # #   # #       #   #   #     #
# # # ### ##### # ### ### # # # # # # # # ####### # ##### # ### #
#   #     #   #     #   # #   # # # # # # #     # # #     # #   #
# ####### # # # ####### # ##### ### # # # # ### ### # ####### # #
#       # # # # #       #       #   # # # # #   #   # #       # #
####### ### # ### ####### ####### ##### # # # ### ### ##### ### #
#           #     #                     #   #     #         #  E#
#################################################################
