#################################################################
#S#   # #         #       #       #     #         #         #   #
# # # # # ### ### ### ### # ##### ##### # ##### # # ####### # # #
#   # # # # # # # #   # # #     #   #   #   #   #   #     # # # #
##### # # # # # # # ### # ##### ### # ##### # ######### # # # # #
#   # # #   # #   # #   #     # #   #       #   #       # # # # #
# # # # # ### # ### # ####### # # ############# # ######### # # #
# # # #   #   #   # #       #   #         #   # # #   #     # # #
# # # ##### ##### # # ##### ############# # # # # # # # ##### # #
# #         #       #     #                 #   #   #         #E#
#################################################################
