#################################################################
#S    #         #     # #               #                 #     #
##### ##### ### # ### # # ########### # # ####### ######### ### #
#   #     # # #   #   #   # #         # #       #           #   #
# # ##### # # ##### ### ### # ######### # ##### ##### ####### # #
# #     # # #   #   # # #   #     #   # # #   # #   #   #   # # #
####### # # # # # ### # # ####### # ### ### # ### # ##### # # # #
#       # # # #   #       #       #   #   # #     # #     # # # #
# ####### # # ############# ####### # ### # ####### # ##### # # #
#           #               #       #       #         #       #E#
#################################################################
