#################################################################
#S#         #                         #             #   #       #
# ##### ### ######### ############### # ####### ### ### # ##### #
#   #   #   #       #       #       # # #     # # #   #   #   # #
### # ### ### ##### ####### # ##### # # ### ### # ### ##### # # #
# # #   #   # #     #     # # #   # #       #   #   # #     # # #
# # # # ### # # ##### ### ### # # # ######### ### # # # ##### # #
# # # # #   # #     # # # #   # # #         # # # #   #   #   # #
# # ### # ### ##### # # # # ### # ######### # # # ####### # ### #
#       #     #       #     #   #             #           #    E#
#################################################################
