#########################
#S#         #           #
# ####### # # ##### ### #
#     #   # #   # # #   #
##### # ####### # # #####
# #   #       #   #     #
# # ### ### ##### ##### #
#   #   # #   #   #     #
# ### ### ### # ### ### #
# #         #     # #   #
# ######### ##### # # ###
#   #     # #   # # # # #
### # # ### # # ### # # #
# # # #     # # #   # # #
# # # ####### # # ### # #
#   #     #   #   # #   #
# ######### ####### ### #
#     #     #     #     #
##### # ####### ### #####
#   # # #       #   #   #
### # # ### ##### ##### #
#   # #   # #   #     # #
# ### ### # # # ##### # #
#         #   #        E#
#########################
