#########################
#S# #         #         #
# # # ####### # # #######
# #     #     # # #     #
# ####### ##### # # ### #
#       #   #   #   #   #
####### ### # ##### # # #
#     #   #   #   # # # #
# ####### ##### # ### # #
# #     # #     #     # #
# # ### # # ########### #
#     # #   #   #       #
####### ##### # # #######
#   #       # # #   #   #
# # # ####### # ### # # #
# # # #     # #   # # # #
# # # # ### # ### # # # #
# # # #   #   # #   # # #
# # # ### ##### ####### #
# #   #   #           # #
# ##### ### ######### # #
# #   # #   #     #   # #
# # # # # ### ##### ### #
#   #     #            E#
#########################
