#################################################################
#S  #         #       #         #                     #         #
### # ### ### # # ### # ##### # ##### # ############# # #########
#   # #   # # # # #   # #     #       # #     # #     #         #
# ##### ### # ### # ##### ############### ### # # ############# #
# #     #     #   #     #                 # # #               # #
# # ##### ##### ####### ##### ########### # # ############### # #
#   # #   #   #     # # #   # #         #   #   # #         #   #
##### # ### # ##### # # # # ### ####### ####### # # # ######### #
#           #       #     #     #               #   #          E#
#################################################################
