#################################################################
#S#   #             #             #         #             #     #
# # # # ##### # ### ######### ##### ##### # # ####### ### ### ###
#   # # #   # # # #     #   #   #   #     # #       # # #   #   #
##### ### # ### # ##### # # ### # ### ##### ### ##### # ### ### #
#     #   # #   #     #   #   #   #   #   # #   #     #   #     #
# ##### ### # ### ########### ##### ### ### ##### ##### # ##### #
#     # # # #   #           #     #   #   # #   # # #   #     # #
##### # # # ### # ### ########### ### # # # # # # # # ##### ### #
#       #       #   #                 # #     #   #       #    E#
#################################################################
