#########################
#S#         # #         #
# # ##### # # # ##### # #
# #   #   # #   #     # #
# ### # ### # ### ##### #
# #   # # # #   # #     #
# # ### # # ##### #######
# # # # #       # #     #
# # # # ####### # # ### #
# #   #   #     #   #   #
# ### ### # ##### ### # #
#   # # # # #   #   # # #
### # # # # # # ##### ###
#   #   # # # #     #   #
# ####### # # ##### ### #
#       # # # #   #     #
####### # # # # # ##### #
#   #   # # # # #   #   #
# ### ### # # # ### # ###
#   # #   # # #   #   # #
# # # # # # # ### ##### #
# #   # # # # # #     # #
# ####### # # # ##### # #
#         #   #        E#
#########################
