#########################
#S      #             # #
####### # ##### ##### # #
#       #     # #   #   #
# ######### ### # # ### #
#   #       #   # #     #
### # ####### ### #######
# # #   #     #   #     #
# # ### # ##### ### ### #
# #   # # #     #   # # #
# ### # # ### ##### # # #
# #   # #   # #     #   #
# # ####### # # ##### ###
# #         #   #   # # #
# ################# # # #
#       #           # # #
# ##### ### ### ##### # #
#   #     # #   #     # #
# # ##### ### # # ##### #
# #     #     # # #     #
# ##### ######### # #####
# #   #           #     #
# # # ################# #
#   #                  E#
#########################
