#########################
#S      #               #
####### ########### ### #
#   #   #   #     # # # #
# # # ### # # ### # # # #
# #   #   #   # #   #   #
# ##### ####### ### #####
#   #   #   #       #   #
### # # # # ######### # #
# # # #   #           # #
# # ################### #
#   #       #     #     #
# ### ##### # ### # ### #
# #   #   #   # # # #   #
# ### # # ##### # # #####
#     # #       # #     #
####### ####### # ##### #
# #   # #     # #     # #
# # # # # # ### ##### # #
# # # # # # #       # # #
# # # # ### # ####### # #
# # # #     #       # # #
# # # ##### ####### # # #
#   #             #    E#
#########################
