#################################################################
#S#     #                   #         #       # #               #
# ### # # ### ############# ### ##### ### ### # # ####### ##### #
#   # # #   #         #     #   #   #   # #   #   #     #     # #
### # ### ########### ##### # ### ##### # # ##### ##### ##### ###
# # #     #         #     # #   #       # #     #       #   #   #
# # ##### # ####### ##### # # # # ####### ##### ####### # ##### #
# # #   # # #     #       # # # # #       #     #   #     #   # #
# # # # ### # ############# ### # ####### # ##### # ####### # # #
#     #     #                   #         #       #         #  E#
#################################################################
