#################################################################
#S#                 #                 #               #         #
# ### ############# ######### ####### ######### ##### # ####### #
# #   #   #       #   #     # #       #       #     #     #     #
# # ### # # ### ##### # ### # # ####### ##### ##### ####### ### #
# # #   # # # #     # #   #   #   #       #   #         #   # # #
# # # ### # # ### # # # # ####### ##### # # ######### ### ### # #
#   # #   # #   # # # # #   #     #   # # # #       # #   #     #
##### ##### # # # ### ##### # ##### # ### # # ##### ### ### #####
#             # #           #       #     #   #         #      E#
#################################################################
