#################################################################
#S# #   #   #         #           #         #         #         #
# # # # # # # # ##### ####### # ### ### ### ##### ### ##### # ###
# #   #   # # #   # #   #   # #   #   # #   #   #   #     # #   #
# ######### # ### # ### # # ### # ### # # ### # # # ##### ### # #
#         #   #   #   #   #   # #     # #     # # #   # #   # # #
######### # ### ### # ####### ####### # ####### ##### # ### ### #
#     #   # #   # # #     #   #     # #   #   #     # #   # #   #
# ### # ##### ### # ### ### ### ### ##### # ####### # # ### # # #
#   #         #       #         #         #           #       #E#
#################################################################
