#################################################################
#S#                 #       #           #         #     #       #
# ####### ######### # ### ### ####### ### ### ### # ### # # ### #
#       #     # #   #   #         # #       # #   # # # # #   # #
####### # ### # # ######### ##### # ######### # ### # # ##### # #
#     # #   # # # #       # #   #       #     #   # # # #   # # #
# ### # ### # # # # ##### ### # ######### ####### # # # # # # # #
#   # #   # # #   #     # #   # #       #   #   # # # #   # # # #
# # ##### ### # ####### # # ### # ##### ### # ### # # ##### # # #
# #           #         #   #     #         #       #         #E#
#################################################################
