#########################
#S  #     #     # #     #
### ### # ### # # # ### #
# #     #   # # #     # #
# ######### # # ####### #
#     #   #   # #       #
### ### # ##### # #######
#   #   #     # #   #   #
# ### ####### # # # # # #
#           # # # #   # #
# ########### # ##### # #
# #   #     # #     # # #
### # # ### # ##### ### #
#   #   #         #   # #
# ############### ### # #
# #             #   #   #
# # ######### # ### ### #
#   #   #   # # #     # #
# ##### # # ### # ##### #
#       # #     # #     #
##### ### ### ##### #####
# #   #   #   #   #     #
# # ### ####### # ##### #
#     #         #      E#
#########################
