#########################
#S    #   #             #
##### # # # ##### #######
#   # # #       #       #
# ### # ####### ####### #
#     # #   # #   # #   #
# ##### # # # ### # # # #
#     # # # #       # # #
##### ### # ######### # #
#   # #   #           # #
### # # ############### #
#   #   #           #   #
# # ##### ######### # ###
# # #   # #       # # # #
# # # # # ### ##### # # #
# # # # #   # #     # # #
# # # # ### # # ### # # #
# # # #   #   #   # # # #
# ### # ##### ### # # # #
#     #       #   # # # #
# ############# ##### # #
# #           # #     # #
# ######### # # # ##### #
#           # #        E#
#########################
