#########################
#S#       #       #     #
# ### ### # ##### # ### #
#     #   # #   #   # # #
####### ### ### ##### # #
#     #   #     #     # #
##### ### ##### # ### # #
#   #   #   #   #   # # #
# # ### ### ### ##### # #
# #     # #   #       # #
# ##### # ### ######### #
# #         #     #     #
# # ############# # #####
# # #         #   #     #
# ### ##### ### ####### #
#   #   # #   # #       #
### ### # ### # ### ### #
#   #   #   # # #   #   #
# # # ### # # # # ### ###
# # # #   # # # # #   # #
# # # # ### # # # # ### #
# # #   # # #   # # #   #
# ####### # ##### # # # #
#                 #   #E#
#########################
