#########################
#S    #   #   #         #
##### # # # # ### #######
#   #   # # #   #       #
# ####### # ### ##### # #
#       # #   #     # # #
# # ##### ### ##### # # #
# #     # #   #   # # # #
# ##### # # ### ### ### #
#   #   #   #   #   #   #
# ### # ####### # ### # #
# #   #         # #   # #
### ##### ####### # ### #
#   #   # #       #   # #
# ### ### # ######### # #
# #       #           # #
# ##################### #
#         #           # #
# ####### # ##### # ### #
# #     # #     # # #   #
# # ##### ### ### ### ###
#   #       # #   #   # #
### # ####### # ### ### #
#   #         #        E#
#########################
