#########################
#S    #         #       #
##### # # ##### ### ### #
#   # # #     #   # #   #
# # # ##### # ### # # ###
# #   #   # # # # # # # #
# ##### # ### # # # # # #
# #     # #   #   # # # #
# # ##### # ### ### # # #
#   # #   #   #     # # #
##### # ##### ####### # #
#   #   #   # #         #
# ### ### # # # #########
#   # #   #   #   #     #
### # # ########### ### #
#   # #     #       #   #
# ### # ### # ####### # #
# #   # # #   #     # # #
# # ### # ##### ### # # #
#   #           #   # # #
# ### ############### ###
#   #   #   #       #   #
### ##### # # ##### ### #
#         #   #        E#
#########################
