#################################################################
#S#   #   #                 #     #       #     #       #       #
# # # # # # ##### ##### ##### # # ### ### # # # # ##### # # #####
# # #   #   #   #     #   #   # #     #   # # # # #   # # #     #
# ########### # ####### # # ### ####### ### # # # # # # ####### #
#   #     #   #       # #   #   #     # #   # # #   # #       # #
### # ### # ######### ##### # ### ##### # ### # ##### ####### # #
# #   #   # #   #   #     # # # #       #   # # #   # # #     # #
# ##### ### # # # # ##### ### # # ########### # # # # # # ##### #
#           # #   #           #               #   #   #        E#
#################################################################
