#################################################################
#S#               #   # #         #     #       #   #           #
# ##### # ####### # # # # ### ### # ### # ### # ### # ##### ### #
#     # #     #     # #     # #   #   #     # #   # #     # # # #
##### ##### # ####### ##### # ### ########### ### # ### ### # # #
# #   #   # #     # #   #   #   #   #       # # # #     #   #   #
# # ### # ####### # ### ####### ### # ##### # # # # ##### ### ###
#   #   #   #   # # #   #     # # #   #   # # #   # #     # #   #
# ##### ### # # # # # ### ### # # ##### # # # # ##### ##### ### #
#       #     #   #       #     #       #     #       #        E#
#################################################################
