#########################
#S  # #         #       #
### # # ### ##### ### # #
# # #   #   #     #   # #
# # # ### ### ##### ### #
# # #   #     #     #   #
# # ### ##### # ####### #
# # #   #   # # #     # #
# # # ### # # # # ### # #
# # # #   # # #   #   # #
# # ### ### # ##### #####
# #     #   #     # #   #
# ####### ####### # # # #
#       #   #     #   # #
# ##### ### ####### ### #
# #     # # #     # #   #
# # ### # # # ### ### # #
# #   #   #   # #   # # #
# ### ### ##### ### # ###
# #   #         #   #   #
# # ##### ##### # ##### #
# #     # #   # #       #
# ##### ### # ######### #
#     #     #          E#
#########################
