#########################
#S#       #     #       #
# ##### # ### # # ### # #
# #     #   # # #   # # #
# # ####### # # ### # # #
# #   #       #   # # # #
# ### ########### # # ###
#   #     # #     # #   #
### ##### # # ##### ### #
# #   #   # #     #   # #
# ### # ### ##### ##### #
#   #   #       #       #
# ######### ### ####### #
#         # #       # # #
####### # ### ##### # # #
#       #   #   #   # # #
# ######### # # # ### # #
#   # #   # # # # #   # #
# # # # # # ### # # # # #
# # #   #   #   #   # # #
# # # ##### # ##### ### #
# # # #   #   #   # #   #
# # ### # ##### # ### ###
# #     #       #      E#
#########################
