#################################################################
#S#   #   #           #     #         #           #         #   #
# # # # # # ######### # ##### ### ### ### ####### ### ### ### # #
# # # # # #   #     # #         # # #     #     #   # # #     # #
# # # # # ### # ### # # ##### ### # ########### ### # # ####### #
#   #   # #   #   #   # #   # #   #     #       # # #       #   #
######### # ##### ####### # ### ### ##### # ### # # ### ##### # #
#   #   #   #   #     #   #     # #       # #     # #   #     # #
# ### # ##### # ##### # ######### # ####### ####### ##### ##### #
#     #       #         #                 #               #    E#
#################################################################
