#################################################################
#S      #     #       #             #         #   #       #   # #
####### ### # ### ##### ####### ##### ### ### # # ##### # # # # #
#     #   # #   #       #     # #       # #   # #   #   # # # # #
##### ### # ### ######### ### # # ####### # ### ### # ### # # # #
#   # #   # # # #         #   #     #     # #   #     # #   # # #
# # # # ### # # # ######### ######### ##### # # ####### ##### # #
# #   #     # # # #   #     #       # #   # # #   #   #     # # #
# ########### # # # # # ####### ### # # ### ##### # ### # ### # #
#                 # #           #     #           #     #      E#
#################################################################
