#########################
#S#   #         #       #
# # ### ### ##### ##### #
# #     # #       #     #
# # ##### ######### ### #
# #     #       # # #   #
# ##### # ##### # # #####
#   #   #   # # # #     #
### ### # # # # # ##### #
# #   # # # #       # # #
# ### # # # ####### # # #
#     # # # #   #     # #
# ##### ### # # ####### #
# #   #     # #       # #
# # # ### ### ####### # #
# # #   # #   #     #   #
# ### ### # ##### ##### #
#   #     #     #     # #
### ########### # # ### #
# # #         # # #     #
# # # ####### # ### #####
# # # #       #   #   # #
# # # # ######### ### # #
#     #           #    E#
#########################
