#################################################################
#S# #     #               #       #     #   #       #           #
# # # # # ### ########### # # ##### ### # # # ### # # ### ##### #
# #   # #     #     #     # #     # # # # # # # # # #   # #     #
# ##### ### ##### ### ######### # # # # # # # # # ### ### # #####
# #   # #   #   # #   #       # #     #   #     #     #   #   # #
# # # # ##### # # # ### # ### ######################### ##### # #
#   # #       # #   #   #   #                   #     # #   # # #
##### ######### # ######### ################### # ### # # # # # #
#               #           #                     #     # #    E#
#################################################################
