#########################
#S#       #         #   #
# ##### ### ##### # ### #
# #   #     #     #     #
# # # ##### # ######### #
#   #     # # #     #   #
######### # # # ### # ###
#       # # # #   #   # #
### ##### # # ### ##### #
#   #   # # #   # # #   #
# ### # # # ### # # # # #
#   # #   # #   # #   # #
### # ####### ### ##### #
#   #         # #     # #
# ############# ##### # #
#           #       # # #
# ##### ### ####### # # #
# #   #   # #     # #   #
# # # ### # # ### # ### #
# # #     # # #     #   #
# # ####### # ####### ###
# #       #   #   #   # #
# ####### ##### # # ### #
#       #       #      E#
#########################
