#################################################################
#S    #     #         #     #     #             #     # #       #
##### # ### ### ### # # ### # # ### ##### ### # ### # # # # ### #
#   # # # #   # #   #   #   # #     #   # #   #     # #   #   # #
# # # # # ### ### ####### ### ####### # ### ######### ### ### # #
# #   # #   #   # # #   # #   #       #     #       #   #   # # #
# ##### # # ### # # # # # ##### ############# # ####### ##### # #
# #     # # #   # # # # #       #     #   #   #       # #     # #
# # ##### # # ### # # # ######### # ### # # ####### ### # ##### #
#   #     #       #   #           #     #         #       #    E#
#################################################################
