#########################
#S#     #       #   #   #
# ### # ##### # # # # # #
#   # #   #   # # #   # #
### # ### # ### ####### #
# # # #   # # # #       #
# # # # ### # # # ##### #
# # # #   # #     #   # #
# # # ### # # ##### # # #
# #   #   # # #   # # # #
# ##### ### ### # # # ###
#   #   #   #   #   #   #
### # ##### # ######### #
#   # #     #     #   # #
# # # ### ####### ### # #
# # #   #   #   #     # #
# ##### ### # # # ##### #
#     #   # # #   #     #
# # ##### # # ##### ### #
# #       #   # #   #   #
# ######### ### # ### ###
# #   #         # # #   #
# # # ########### # ### #
#   #             #    E#
#########################
