#################################################################
#S#           #   #       #           #         #     # #       #
# ####### ### # # ####### # ##### ### # ### ### # ### # # # ### #
#       #   # # #       #       #   # #   # # #   # # #   #   # #
####### ### # # ####### # ##### ### # # ### # ##### # ####### # #
# #   #   # # # #     # # #   #   # # # #   # #     #       # # #
# # # ### # # # # ### # ### # ### # # ### ### # ### ####### # # #
# # #   #   # # # #   #     # #   # #     #     #     #   # # # #
# # ### ##### # # ########### ##### ####### ##### ##### # # # # #
#     #         #                   #           #       #     #E#
#################################################################
