#########################
#S#         # #   #     #
# ### ##### # # # # ### #
#   # #   # #   # # #   #
### # # # # ### # # # ###
# #   # # #   # #   #   #
# ##### # ### # ####### #
#     # # #   # #     # #
# # # # # # ##### ### # #
# # # # # # #     # #   #
### # ### # ### ### ### #
#   #     #   #   # #   #
# ##### ##### ### # # ###
# #     #   # #   #   # #
# # ##### # # # ##### # #
# #   #   #   # #   #   #
# ##### ####### # # #####
#     #       #   # #   #
# ### ####### ### # # # #
# # #       #   # #   # #
# # ### ####### ### ### #
#     # #     #   #   # #
##### # # ### ### ##### #
#     #     #          E#
#########################
