#########################
#S  #   #   #     #     #
### # # # # ### ### # # #
# # # #   #     #   # # #
# # # ####### ### ### ###
#   #     # # #   # #   #
# ### ### # # # ### ### #
# #   # # #   # #     # #
# # ### # # ### ### ### #
# #     # #   #   # #   #
# ####### # ##### # # # #
#       # # #   #   # # #
####### # ### # ### # ###
# #     #     #   # #   #
# # ########### ### ### #
# #       #   # #     # #
# ####### # # # # ##### #
#   #     # # #   #     #
# # # ##### # ##### ### #
# #   #     #     # #   #
# ##### ######### # # ###
#   #   #   #   #   # # #
### ### # ### # ##### # #
#       #     #        E#
#########################
