#################################################################
#S  #   #         #             #         #   #           #     #
### # ### # ####### ##### ####### ##### # # # # ####### # ### # #
# # #     #   #   # #   # #           # # # # # #   #   #     # #
# # ### ##### # # # # # # # ######### # # # ### # # # ######### #
# #   # #   #   #   # # # # #       # # # #       # # #       # #
# ### # # # ##### ### # # # # ##### ### # ########### ### # # # #
#     # # # #   #   # # #   #   # #     # #     #   #   # # # # #
# ####### # # # ##### # ####### # ####### # ### # # ### # # ### #
#         #   #       #         #           #     #     # #    E#
#################################################################
