#################################################################
#S# #         #             #     #           #   #       #     #
# # # ### ### # ##### ### # # ### # ##### ### # # # ### # ##### #
# #   # #   # # #   # #   #   #   #     #   #   # #   # #     # #
# ### # ### # ### # # # ####### ########### ######### # ##### # #
#   #   #   #     # # #     #             #           # #   # # #
### # ### ######### ####### ############# ####### ##### # # # # #
#   # #   # #     #       #   #     #   #       #   #   # # # # #
# ##### ### # ### ####### ### # ##### # ####### ##### ### ### # #
#       #       #             #       #               #        E#
#################################################################
